RRRRRRWKKWKKKKWKKWKKKWWWWKKWBBBBBBBBWWYYYYYWYYYYYWKKWKKKKWKKWGGGGYYGGGGGGGGGGGGGGGGGYYGGGGGGGGGGGGGGGGGGGYYGG
RRRRRRWKKWKKKKWKKWKKKWWWWKKWBBBBBBBBWWYYYYYWYYYYYWKKWKKKKWKKWGGGGYYGGGGGGGGGGGGGGGGGYYGGGGGGGGGGGGGGGGGGGYYGG
RRRRRRWKKWKKKKWKKWKKKWWWWKKWBBBBBBBBWWYYYYYWYYYYYWKKWKKKKWKKWGGGGYYGGGGGGGGGGGGGGGGGYYGGGGGGGGGGGGGGGGGGGYYGG
RRRRRRWKKWKKKKWKKWKKKWWWWKKWBBBBBBBBWWYYYYYWYYYYYWKKWKKKKWKKWGGGGYYGGGGGGGGGGGGGGGGGYYYYYYYYYYYYYYYYYYYYYYYGG
RRRRRRKKKWKKKKWKKWKKKWWWWKKWBBBBBBBBWWYYYYYWYYYYYWKKWKKKKWKKWGGGGYYGGGGGGGGGGGGGGGGGYYYYYYYYYYYYYYYYYYYYYYYGG
RRRRRRKKKWKKKKWKKWKKKWWWWKKWBBBBBBBBWWYYYYYWYYYYYWKKWKKKKWKKWGGGGYYGGGGGGGGGGGGGGGGGYYGGGGGGGGGGGGGGGGGGGGGGG
RRRRRRWKKWKKKKWKKWKKKWWWWKKWBBBBBBBBWWYYYYYWYYYYYWKKWKKKKWKKWGGGGYYYYYYYYYYYYYYYYYYYYYGGGGGGGGGGGGGGGGGGGGGGG
RRRRRRWKKWKKKKWKKWKKKWWWWKKWBBBBBBBBWWYYYYYWYYYYYWKKWKKKKWKKWGGGGYYYYYYYYYYYYYYYYYYYYYGGGGGGGGGGGGGGGGGGGGGGG
RRRRRRWKKWKKKKWKKWKKKWWWWKKWBBBBBBBBWWYYYYYWYYYYYWKKWKKKKWKKWGGGGGGGGGGYYGGGGGGGGGGGGGGGGGGGGGGGGGGGGGGGGGGGG
RRRRRRWKKWKKKKWKKWKKKWWWWKKWBBBBBBBBWWYYYYYWYYYYYWKKWKKKKWKKWGGGGGGGGGGYYGGGGGGGGGGGGGGGGGGGGGGGGGGGGGGGGGGGG
RRRRRRWKKWKKKKWKKWKKKWWWWKKWBBBBBBBBWWYYYYYWYYYYYWKKWKKKKWKKWGGGGGGGGGGYYGGGGGGGGGGGGGGGGGGGGGGGGGGGGGGGGGGGG
WWWWWWWKKWKKKKWKKWWWWWKKWKKWWWKKKKWWWWYYYYYWYYYYYWKKWKKKKWKKWWWWWWWWWWWKKWWWWWWWWWWWWWWWWWWWWWWWWWWWWWWWWWWWW
KKKKKKKKKWWWWWWKKKKKKWWWWKKKKKKKKKKKKWYYYYYWYYYYYWKKWWWWWWKKKKKKKKKKKKKKKKKKKKKKKKKKKKKKKKKKKKKKKKKKKKKKKKKKK
KKKKKKKKKWWWWWWKKKKKKWWWWKKKKKKKKKKKKWYYYYYWYYYYYWKKWWWWWWKKKKKKKKKKKKKKKKKKKKKKKKKKKKKKKKKKKKKKKKKKKKKKKKKKK
WWWWWWWWWWKKKKWWWWWWWWKKWWWWWWWWWWWWWWYYYYYWYYYYYWWWWWWWWWWWWWWWWWWWWWWWWWWWWWWWWWWWWWWWWWWWWWWWWWWWWWWWWWWWW
KKKKKKKKKKKKKKKKKKKKKKKKKKKKKKKKKKKKKWYYYYYWYYYYYWKKKKKKKKKKKKKKKKKKKKKKKKKKKKKKKKKKKKKKKKKKKKKKKKKKKKKKKKKKK
WWKKWWKKWWKKWWKKWWKKWWKKWWKKWWKKWWKKWWYYYYYWYYYYYWWKKWWKKWWKKWWKKWWKKWWKKWWKKWWKKWWKKWWKKWWKKWWKKWWKKWWKKWWKK
KKKKKKKKKKKKKKKKKKKKKKKKKKKKKKKKKKKKKWYYYYYWYYYYYWKKKKKKKKKKKKKKKKKKKKKKKKKKKKKKKKKKKKKKKKKKKKKKKKKKKKKKKKKKK
WWWWWWWWWWWWWWWWWWWWWWWWKKKKWWWWWWWWWWYYYYYWYYYYYWWWWWWWWWWWWWWWWWWWWWWWWWWKKKKWWWWWWWWWWWWWWWWWWWWWWWWWWWWWW
KKKKKKKKKKKKKKKKKKKKKKKWWWWWWKKKKKKKKWYYYYYWYYYYYWKKKKKKKKKKKKKKKKKKKKKKKKWWWWWWKKKKKKKKKKKKKKKKKKKKKKKKKKKKK
KKKKKKKKKKKKKKKKKKKKKKKWWWWWWKKKKKKKKWYYYYYWYYYYYWKKKKKKKKKKKKKKKKKKKKKKKKWWWWWWKKKKKKKKKKKKKKKKKKKKKKKKKKKKK
WWWWWWWWWWWWWWWWWWWWWKKWKKKKWKKKKKKKKWYYYYYWYYYYYWKKKKKKKKKKKKKKKKKKKKKKKKWKKKKWKKRRRRRRRRRRRRMKKMRRRRRRRRRRR
BBBBBBWGGGGGGWYYYYYYWKKWKKKKWKKKKKKKKWYYYYYWYYYYYWKKKKKKKKKKKKKKKKKKKKKKKKWKKKKWKKRMMMMMMMMMMMMWWMMMMMMMMMMMM
BBBBBBWGGGGGGWYYYYYYWKKWKKKKWKKKKKKKKWYYYYYWYYYYYWKKKKKKKKKKKKKKKKKKKKKKKKWKKKKWKKRMKCCCCCCCCCCCCCCCCCCCCCCKM
BBBBBBWGGGGGGWYYYYYYWKKWKKKKWKKKKKKKKWYYYYYWYYYYYWKKKKKKKKKKKKKKKKKKKKKKKKWKKKKWKKRMKCGGGGGWCKKKKKKCWGGGGGCKM
WWKKWWWWWKKWWWWWKKWWWKKWKKKKWKKKKKKKKWYYYYYWYYYYYWKKKKKKKKKKKKKKKKKKKKKKKKWKKKKWKKRMKCCCCCCCCCCCCCCCCCCCCCCKM
KKKKKKKKKKKKKKKKKKKKKKKWKKKKWKKKKKKKKWYYYYYWYYYYYWKKKKKKKKKKKKKKKKKKKKKKKKWKKKKWKKRMKCGGGGGWCKKKKKKCWGGGGGCKM
KKKKKKKKKKKKKKKKKKKKKKKWKKKKWKKKKKKKKWYYYYYWYYYYYWKKKKKKKKKKKKKKKKKKKKKKKKWKKKKWKKRMKCCCCCCCCCCCCCCCCCCCCCCKM
WWWWWWWWWWWWWWWWWWWWWKKWKKKKWKKKKKKKKWYYYYYWYYYYYWKKKKKKKKKKKKKKKKKKKKKKKKWKKKKWKKRMKCGGGGGWCKKKKKKCWGGGGGCKM
YYYYYYWBBBBBBWRRRRRRWKKWKKKKWKKKKKKKKWYYYYYWYYYYYWKKKKKKKKKKKKKKKKKKKKKKKKWKKKKWKKRMKCCCCCCCCCCCCCCCCCCCCCCKM