109 30
██████│░░│    │░░│   ‗‗‗│░░│████████║╣│───│║│───│╠░░│    │░░│▒▒▒▒▓▓▒▒▒▒▒▒▒▒▒▒▒▒▒▒▒▒▒▓▓▒▒▒▒▒▒▒▒▒▒▒▒▒▒▒▒▒▒▒▓▓▒▒
██████║░░│    │░░│   ‗‗‗│░░│████████║╣│───│║│───│╠░░│    │░░│▒▒▒▒▓▓▒▒▒▒▒▒▒▒▒▒▒▒▒▒▒▒▒▓▓▒▒▒▒▒▒▒▒▒▒▒▒▒▒▒▒▒▒▒▓▓▒▒
██████│░░│    │░░│   ‗‗‗│░░║████████║╣│───│║│───│╠░░│    │░░│▒▒▒▒▓▓▒▒▒▒▒▒▒▒▒▒▒▒▒▒▒▒▒▓▓▒▒▒▒▒▒▒▒▒▒▒▒▒▒▒▒▒▒▒▓▓▒▒
██████╚░░│    │░░│   ‗‗‗│░░│████████║╣│───│║│───│╠░░│    │░░│▒▒▒▒▓▓▒▒▒▒▒▒▒▒▒▒▒▒▒▒▒▒▒▓▓▓▓▓▓▓▓▓▓▓▓▓▓▓▓▓▓▓▓▓▓▓▒▒
██████▓░░│    │░░│   ‗‗‗│░░│████████║╣│───│║│───│╠░░│    │░░│▒▒▒▒▓▓▒▒▒▒▒▒▒▒▒▒▒▒▒▒▒▒▒▓▓▓▓▓▓▓▓▓▓▓▓▓▓▓▓▓▓▓▓▓▓▓▒▒
██████▓░░│    │░░│   ‗‗‗│░░║████████║╣│───│║│───│╠░░│    │░░│▒▒▒▒▓▓▒▒▒▒▒▒▒▒▒▒▒▒▒▒▒▒▒▓▓▒▒▒▒▒▒▒▒▒▒▒▒▒▒▒▒▒▒▒▒▒▒▒
██████╔░░│    │░░│   ‗‗‗│░░│████████║╣│───│║│───│╠░░│    │░░│▒▒▒▒▓▓▓▓▓▓▓▓▓▓▓▓▓▓▓▓▓▓▓▓▓▒▒▒▒▒▒▒▒▒▒▒▒▒▒▒▒▒▒▒▒▒▒▒
██████│░░│    │░░│   ‗‗‗│░░│████████║╣│───│║│───│╠░░│    │░░│▒▒▒▒▓▓▓▓▓▓▓▓▓▓▓▓▓▓▓▓▓▓▓▓▓▒▒▒▒▒▒▒▒▒▒▒▒▒▒▒▒▒▒▒▒▒▒▒
██████║░░│    │░░│   ‗‗‗│░░║████████║╣│───│║│───│╠░░│    │░░│▒▒▒▒▒▒▒▒▒▒▓▓▒▒▒▒▒▒▒▒▒▒▒▒▒▒▒▒▒▒▒▒▒▒▒▒▒▒▒▒▒▒▒▒▒▒▒▒
██████│░░│    │░░│   ‗‗‗│░░│████████║╣│───│║│───│╠░░│    │░░│▒▒▒▒▒▒▒▒▒▒▓▓▒▒▒▒▒▒▒▒▒▒▒▒▒▒▒▒▒▒▒▒▒▒▒▒▒▒▒▒▒▒▒▒▒▒▒▒
██████║░░│    │░░│      │░░│████████║╣│───│║│───│╠░░│    │░░│▒▒▒▒▒▒▒▒▒▒▓▓▒▒▒▒▒▒▒▒▒▒▒▒▒▒▒▒▒▒▒▒▒▒▒▒▒▒▒▒▒▒▒▒▒▒▒▒
──═──═╝░░│    │░░└───┐  │░░╚─╗▓▓▓▓╔─╝╣│───│║│───│╠░░│    │░░└─────────┘░░└───────────────────────────────────
░░░░░░░░░││││││░░░░░░││││░░░░░░░░░░░░║│───│║│───│║░░││││││░░░░░░░░░░░░░░░░░░░░░░░░░░░░░░░░░░░░░░░░░░░░░░░░░░░
░░░░░░░░░││││││░░░░░░││││░░░░░░░░░░░░║│───│║│───│║░░││││││░░░░░░░░░░░░░░░░░░░░░░░░░░░░░░░░░░░░░░░░░░░░░░░░░░░
─────────┘    └──────┘  └────────────║│───│║│───│║──┘    └───────────────────────────────────────────────────
                                     ║│───│║│───│║                                                           
══  ══  ══  ══  ══  ══  ══  ══  ══  ═║│───│║│───│║═  ══  ══  ══  ══  ══  ══  ══  ══  ══  ══  ══  ══  ══  ══  
                                     ║│───│║│───│║                                                           
───────────────────────┐    ┌────────║│───│║│───│║────────────────────────┐    ┌─────────────────────────────
░░░░░░░░░░░░░░░░░░░░░░░││││││░░░░░░░░║│───│║│───│║░░░░░░░░░░░░░░░░░░░░░░░░││││││░░░░░░░░░░░░░░░░░░░░░░░░░░░░░
░░░░░░░░░░░░░░░░░░░░░░░││││││░░░░░░░░║│───│║│───│║░░░░░░░░░░░░░░░░░░░░░░░░││││││░░░░░░░░░░░░░░░░░░░░░░░░░░░░░
═─══─═╦═─══─═╦═─══─═╗░░│    │░░      ╣│───│║│───│╠                      ░░│    │░░╔══════════╝█▓▓█╚══════════
██████║██████║██████║░░│    │░░      ╣│───│║│───│╠                      ░░│    │░░║████████████  ████████████
██████║██████║██████│░░│    │░░      ╣│───│║│───│╠                      ░░│    │░░║█ ┌──────┬─┘  └─┬──────┐ █
██████║██████║██████║░░│    │░░      ╣│───│║│───│╠                      ░░│    │░░║█ │▒▒▒▒▒█│      │█▒▒▒▒▒│ █
═╗▓▓╔═╩═╗▓▓╔═╩═╗▓▓╔═╝░░│    │░░      ╣│───│║│───│╠                      ░░│    │░░║█ ├──────┼──────┼──────┤ █
░░░░░░░░░░░░░░░░░░░░░░░│    │░░      ╣│───│║│───│╠                      ░░│    │░░║█ │▒▒▒▒▒█│      │█▒▒▒▒▒│ █
░░░░░░░░░░░░░░░░░░░░░░░│    │░░      ╣│───│║│───│╠                      ░░│    │░░║█ ├──────┼──────┼──────┤ █
═─══─═╦═─══─═╦═─══─═╗░░│    │░░      ╣│───│║│───│╠                      ░░│    │░░║█ │▒▒▒▒▒█│      │█▒▒▒▒▒│ █
██████║██████║██████║░░│    │░░      ╣│───│║│───│╠                      ░░│    │░░║█ ├──────┼──────┼──────┤ █