RRRRRRWKKKWKKKWKKKWKKWWWWKKKWBBBBBBBWWYYYYYWYYYYYWKKKWKKKWKKWGGGGYYGGGGGGGGGGGGGGGGGYYGGGGGGGGGGGGGGGGGGGYYGG
RRRRRRWKKKWKKKWKKKWKKWWWWKKKWBBBBBBBWWYYYYYWYYYYYWKKKWKKKWKKWGGGGYYGGGGGGGGGGGGGGGGGYYGGGGGGGGGGGGGGGGGGGYYGG
RRRRRRWKKKWKKKWKKKWKKWWWWKKKWBBBBBBBWWYYYYYWYYYYYWKKKWKKKWKKWGGGGYYGGGGGGGGGGGGGGGGGYYGGGGGGGGGGGGGGGGGGGYYGG
RRRRRRWKKKWKKKWKKKWKKWWWWKKKWBBBBBBBWWYYYYYWYYYYYWKKKWKKKWKKWGGGGYYGGGGGGGGGGGGGGGGGYYYYYYYYYYYYYYYYYYYYYYYGG
RRRRRRKKKKWKKKWKKKWKKWWWWKKKWBBBBBBBWWYYYYYWYYYYYWKKKWKKKWKKWGGGGYYGGGGGGGGGGGGGGGGGYYYYYYYYYYYYYYYYYYYYYYYGG
RRRRRRKKKKWKKKWKKKWKKWWWWKKKWBBBBBBBWWYYYYYWYYYYYWKKKWKKKWKKWGGGGYYGGGGGGGGGGGGGGGGGYYGGGGGGGGGGGGGGGGGGGGGGG
RRRRRRWKKKWKKKWKKKWKKWWWWKKKWBBBBBBBWWYYYYYWYYYYYWKKKWKKKWKKWGGGGYYYYYYYYYYYYYYYYYYYYYGGGGGGGGGGGGGGGGGGGGGGG
RRRRRRWKKKWKKKWKKKWKKWWWWKKKWBBBBBBBWWYYYYYWYYYYYWKKKWKKKWKKWGGGGYYYYYYYYYYYYYYYYYYYYYGGGGGGGGGGGGGGGGGGGGGGG
RRRRRRWKKKWKKKWKKKWKKWWWWKKKWBBBBBBBWWYYYYYWYYYYYWKKKWKKKWKKWGGGGGGGGGGYYGGGGGGGGGGGGGGGGGGGGGGGGGGGGGGGGGGGG
RRRRRRWKKKWKKKWKKKWKKWWWWKKKWBBBBBBBWWYYYYYWYYYYYWKKKWKKKWKKWGGGGGGGGGGYYGGGGGGGGGGGGGGGGGGGGGGGGGGGGGGGGGGGG
RRRRRRWKKKWKKKWKKKWKKWWWWKKKWBBBBBBBWWYYYYYWYYYYYWKKKWKKKWKKWGGGGGGGGGGYYGGGGGGGGGGGGGGGGGGGGGGGGGGGGGGGGGGGG
WWWWWWWKKKWKKKWKKKWWWWKKWKKKWWWKKKWWWWYYYYYWYYYYYWKKKWKKKWKKWWWWWWWWWWWKKWWWWWWWWWWWWWWWWWWWWWWWWWWWWWWWWWWWW
KKKKKKKKKKWWWWWKKKKKKWWWWKKKKKKKKKKKKWYYYYYWYYYYYWKKKWWWWWKKKKKKKKKKKKKKKKKKKKKKKKKKKKKKKKKKKKKKKKKKKKKKKKKKK
KKKKKKKKKKWWWWWKKKKKKWWWWKKKKKKKKKKKKWYYYYYWYYYYYWKKKWWWWWKKKKKKKKKKKKKKKKKKKKKKKKKKKKKKKKKKKKKKKKKKKKKKKKKKK
WWWWWWWWWWWKKKWWWWWWWWKKWWWWWWWWWWWWWWYYYYYWYYYYYWWWWWKKWWWWWWWWWWWWWWWWWWWWWWWWWWWWWWWWWWWWWWWWWWWWWWWWWWWWW
KKKKKKKKKKKKKKKKKKKKKKKKKKKKKKKKKKKKKWYYYYYWYYYYYWKKKKKKKKKKKKKKKKKKKKKKKKKKKKKKKKKKKKKKKKKKKKKKKKKKKKKKKKKKK
WWKKWWKKWWKKWWKKWWKKWWKKWWKKWWKKWWKKWWYYYYYWYYYYYWWKKWWKKWWKKWWKKWWKKWWKKWWKKWWKKWWKKWWKKWWKKWWKKWWKKWWKKWWKK
KKKKKKKKKKKKKKKKKKKKKKKKKKKKKKKKKKKKKWYYYYYWYYYYYWKKKKKKKKKKKKKKKKKKKKKKKKKKKKKKKKKKKKKKKKKKKKKKKKKKKKKKKKKKK
WWWWWWWWWWWWWWWWWWWWWWWWWKKKWWWWWWWWWWYYYYYWYYYYYWWWWWWWWWWWWWWWWWWWWWWWWWWWKKWWWWWWWWWWWWWWWWWWWWWWWWWWWWWWW
KKKKKKKKKKKKKKKKKKKKKKKKWWWWWKKKKKKKKWYYYYYWYYYYYWKKKKKKKKKKKKKKKKKKKKKKKKKWWWWKKKKKKKKKKKKKKKKKKKKKKKKKKKKKK
KKKKKKKKKKKKKKKKKKKKKKKKWWWWWKKKKKKKKWYYYYYWYYYYYWKKKKKKKKKKKKKKKKKKKKKKKKKWWWWKKKKKKKKKKKKKKKKKKKKKKKKKKKKKK
WWWWWWWWWWWWWWWWWWWWWKKKWKKKWKKKKKKKKWYYYYYWYYYYYWKKKKKKKKKKKKKKKKKKKKKKKKKWKKWKKKRRRRRRRRRRRRMKKKMRRRRRRRRRR
BBBBBBWGGGGGGWYYYYYYWKKKWKKKWKKKKKKKKWYYYYYWYYYYYWKKKKKKKKKKKKKKKKKKKKKKKKKWKKWKKKRMMMMMMMMMMMMWWMMMMMMMMMMMM
BBBBBBWGGGGGGWYYYYYYWKKKWKKKWKKKKKKKKWYYYYYWYYYYYWKKKKKKKKKKKKKKKKKKKKKKKKKWKKWKKKRMKCCCCCCCCCCCCCCCCCCCCCCCK
BBBBBBWGGGGGGWYYYYYYWKKKWKKKWKKKKKKKKWYYYYYWYYYYYWKKKKKKKKKKKKKKKKKKKKKKKKKWKKWKKKRMKCGGGGGWCKKKKKKKCWGGGGGCK
WWKKWWWWWKKWWWWWKKWWWKKKWKKKWKKKKKKKKWYYYYYWYYYYYWKKKKKKKKKKKKKKKKKKKKKKKKKWKKWKKKRMKCCCCCCCCCCCCCCCCCCCCCCCK
KKKKKKKKKKKKKKKKKKKKKKKKWKKKWKKKKKKKKWYYYYYWYYYYYWKKKKKKKKKKKKKKKKKKKKKKKKKWKKWKKKRMKCGGGGGWCKKKKKKKCWGGGGGCK
KKKKKKKKKKKKKKKKKKKKKKKKWKKKWKKKKKKKKWYYYYYWYYYYYWKKKKKKKKKKKKKKKKKKKKKKKKKWKKWKKKRMKCCCCCCCCCCCCCCCCCCCCCCCK
WWWWWWWWWWWWWWWWWWWWWKKKWKKKWKKKKKKKKWYYYYYWYYYYYWKKKKKKKKKKKKKKKKKKKKKKKKKWKKWKKKRMKCGGGGGWCKKKKKKKCWGGGGGCK
YYYYYYWBBBBBBWRRRRRRWKKKWKKKWKKKKKKKKWYYYYYWYYYYYWKKKKKKKKKKKKKKKKKKKKKKKKKWKKWKKKRMKCCCCCCCCCCCCCCCCCCCCCCCK
