WWWWWWWWWCWWWWCWWCWWWWWWCWWCWWWWWWWWWWRRRRRWRRRRRWWWCWWWWCWWCGGGGYYGGGGGGGGGGGGGGGGGYYGGGGGGGGGGGGGGGGGGGYYGG
WWWWWWWWWCWWWWCWWCWWWWWWCWWCWWWWWWWWWWRRRRRWRRRRRWWWCWWWWCWWCGGGGYYGGGGGGGGGGGGGGGGGYYGGGGGGGGGGGGGGGGGGGYYGG
WWWWWWWWWCWWWWCWWCWWWWWWCWWCWWWWWWWWWWRRRRRWRRRRRWWWCWWWWCWWCGGGGYYGGGGGGGGGGGGGGGGGYYGGGGGGGGGGGGGGGGGGGYYGG
WWWWWWWWWCWWWWCWWCWWWWWWCWWCWWWWWWWWWWRRRRRWRRRRRWWWCWWWWCWWCGGGGYYGGGGGGGGGGGGGGGGGYYYYYYYYYYYYYYYYYYYYYYYGG
WWWWWWWWWCWWWWCWWCWWWWWWCWWCWWWWWWWWWWRRRRRWRRRRRWWWCWWWWCWWCGGGGYYGGGGGGGGGGGGGGGGGYYYYYYYYYYYYYYYYYYYYYYYGG
WWWWWWWWWCWWWWCWWCWWWWWWCWWCWWWWWWWWWWRRRRRWRRRRRWWWCWWWWCWWCGGGGYYGGGGGGGGGGGGGGGGGYYGGGGGGGGGGGGGGGGGGGGGGG
WWWWWWWWWCWWWWCWWCWWWWWWCWWCWWWWWWWWWWRRRRRWRRRRRWWWCWWWWCWWCGGGGYYYYYYYYYYYYYYYYYYYYYGGGGGGGGGGGGGGGGGGGGGGG
WWWWWWWWWCWWWWCWWCWWWWWWCWWCWWWWWWWWWWRRRRRWRRRRRWWWCWWWWCWWCGGGGYYYYYYYYYYYYYYYYYYYYYGGGGGGGGGGGGGGGGGGGGGGG
WWWWWWWWWCWWWWCWWCWWWWWWCWWCWWWWWWWWWWRRRRRWRRRRRWWWCWWWWCWWCGGGGGGGGGGYYGGGGGGGGGGGGGGGGGGGGGGGGGGGGGGGGGGGG
WWWWWWWWWCWWWWCWWCWWWWWWCWWCWWWWWWWWWWRRRRRWRRRRRWWWCWWWWCWWCGGGGGGGGGGYYGGGGGGGGGGGGGGGGGGGGGGGGGGGGGGGGGGGG
WWWWWWWWWCWWWWCWWCWWWWWWCWWCWWWWWWWWWWRRRRRWRRRRRWWWCWWWWCWWCGGGGGGGGGGYYGGGGGGGGGGGGGGGGGGGGGGGGGGGGGGGGGGGG
WWWWWWWWWCWWWWCWWCCCCWWWCWWWWWWWWWWWWWRRRRRWRRRRRWWWCWWWWCWWCCCCCCCCCCCYYCCCCCCCCCCCCCCCCCCCCCCCCCCCCCCCCCCCC
WWWWWWWWWCWWWWCWWWWWCWWWCWWWWWWWWWWWWWRRRRRWRRRRRWWWCWWWWCWWWWWWWWWWWWWWWWWWWWWWWWWWWWWWWWWWWWWWWWWWWWWWWWWWW
WWWWWWWWWCWWWWCWWWWWCWWWCWWWWWWWWWWWWWRRRRRWRRRRRWWWCWWWWCWWWWWWWWWWWWWWWWWWWWWWWWWWWWWWWWWWWWWWWWWWWWWWWWWWW
CCCCCCCCCCWWWWCCCCCCCWWWCCCCCCCCCCCCCWRRRRRWRRRRRWCCCWWWWCCCCCCCCCCCCCCCCCCCCCCCCCCCCCCCCCCCCCCCCCCCCCCCCCCCC
WWWWWWWWWWWWWWWWWWWWWWWWWWWWWWWWWWWWWWRRRRRWRRRRRWWWWWWWWWWWWWWWWWWWWWWWWWWWWWWWWWWWWWWWWWWWWWWWWWWWWWWWWWWWW
WWWWWWWWWWWWWWWWWWWWWWWWWWWWWWWWWWWWWWRRRRRWRRRRRWWWWWWWWWWWWWWWWWWWWWWWWWWWWWWWWWWWWWWWWWWWWWWWWWWWWWWWWWWWW
WWWWWWWWWWWWWWWWWWWWWWWWWWWWWWWWWWWWWWRRRRRWRRRRRWWWWWWWWWWWWWWWWWWWWWWWWWWWWWWWWWWWWWWWWWWWWWWWWWWWWWWWWWWWW
CCCCCCCCCCCCCCCCCCCCCCCCWWWWCCCCCCCCCWRRRRRWRRRRRWCCCCCCCCCCCCCCCCCCCCCCCCCWWWWCCCCCCCCCCCCCCCCCCCCCCCCCCCCCC
WWWWWWWWWWWWWWWWWWWWWWWCWWWWCWWWWWWWWWRRRRRWRRRRRWWWWWWWWWWWWWWWWWWWWWWWWWCWWWWCWWWWWWWWWWWWWWWWWWWWWWWWWWWWW
WWWWWWWWWWWWWWWWWWWWWWWCWWWWCWWWWWWWWWRRRRRWRRRRRWWWWWWWWWWWWWWWWWWWWWWWWWCWWWWCWWWWWWWWWWWWWWWWWWWWWWWWWWWWW
WWWWWWWWWWWWWWWWWWWWWWWCWWWWCWWWWWWWWWRRRRRWRRRRRWWWWWWWWWWWWWWWWWWWWWWWWWCWWWWCWWWWWWWWWWWWWWWWWWWWWWWWWWWWW
WWWWWWWWWWWWWWWWWWWWWWWCWWWWCWWWWWWWWWRRRRRWRRRRRWWWWWWWWWWWWWWWWWWWWWWWWWCWWWWCWWWWWWWWWWWWWWWWWWWWWWWWWWWWW
WWWWWWWWWWWWWWWWWWWWWWWCWWWWCWWWWWWWWWRRRRRWRRRRRWWWWWWWWWWWWWWWWWWWWWWWWWCWWWWCWWWWWCWWWWWWWWWWWWWWWWWWWWCWW
WWWWWWWWWWWWWWWWWWWWWWWCWWWWCWWWWWWWWWRRRRRWRRRRRWWWWWWWWWWWWWWWWWWWWWWWWWCWWWWCWWWWWCCCCCCCCCCCCCCCCCCCCCCWW
WWWWWWWWWWWWWWWWWWWWWWWCWWWWCWWWWWWWWWRRRRRWRRRRRWWWWWWWWWWWWWWWWWWWWWWWWWCWWWWCWWWWWCGGGGGWCWWWWWWCWGGGGGCWW
WWWWWWWWWWWWWWWWWWWWWWWCWWWWCWWWWWWWWWRRRRRWRRRRRWWWWWWWWWWWWWWWWWWWWWWWWWCWWWWCWWWWWCCCCCCCCCCCCCCCCCCCCCCWW
WWWWWWWWWWWWWWWWWWWWWWWCWWWWCWWWWWWWWWRRRRRWRRRRRWWWWWWWWWWWWWWWWWWWWWWWWWCWWWWCWWWWWCGGGGGWCWWWWWWCWGGGGGCWW
WWWWWWWWWWWWWWWWWWWWWWWCWWWWCWWWWWWWWWRRRRRWRRRRRWWWWWWWWWWWWWWWWWWWWWWWWWCWWWWCWWWWWCCCCCCCCCCCCCCCCCCCCCCWW
WWWWWWWWWWWWWWWWWWWWWWWCWWWWCWWWWWWWWWRRRRRWRRRRRWWWWWWWWWWWWWWWWWWWWWWWWWCWWWWCWWWWWCGGGGGWCWWWWWWCWGGGGGCWW