BBWWRRWKKKWKKKWKKKWKKWWWWKKKWBBBBBBBWWYYYYYWYYYYYWKKKWKKKWKKKWGGGYYGGGGGGGGGGGGGGGGGYYGGGGGGGGGGGGGGGGGGGYYGG
BBWWRRWKKKWKKKWKKKWKKWWWWKKKWBBBBBBBWWYYYYYWYYYYYWKKKWKKKWKKKWGGGYYGGGGGGGGGGGGGGGGGYYGGGGGGGGGGGGGGGGGGGYYGG
BBWWRRWKKKWKKKWKKKWKKWWWWKKKWBBBBBBBWWYYYYYWYYYYYWKKKWKKKWKKKWGGGYYGGGGGGGGGGGGGGGGGYYGGGGGGGGGGGGGGGGGGGYYGG
BBWWRRWKKKWKKKWKKKWKKWWWWKKKWBYYYYYBWWYYYYYWYYYYYWKKKWKKKWKKKWGGGYYGGGGGGGGGGGGGGGGGYYYYYYYYYYYYYYYYYYYYYYYGG
BBWWRRKKKKWKKKWKKKWKKWWWWKKKWBBBBBBBWWYYYYYWYYYYYWKKKWKKKWKKKWGGGYYGGGGGGGGGGGGGGGGGYYYYYYYYYYYYYYYYYYYYYYYGG
BBWWRRKKKKWKKKWKKKWKKWWWWKKKWBBBCBBBWWYYYYYWYYYYYWKKKWKKKWKKKWGGGYYGGGGGGGGGGGGGGGGGYYGGGGGGGGGGGGGGGGGGGGGGG
BBWWRRWKKKWKKKWKKKWKKWWWWKKKWBBBBBBBWWYYYYYWYYYYYWKKKWKKKWKKKWGGGYYYYYYYYYYYYYYYYYYYYYGGGGGGGGGGGGGGGGGGGGGGG
BBWWRRWKKKWKKKWKKKWKKWWWWKKKWBBBYBBBWWYYYYYWYYYYYWKKKWKKKWKKKWGGGYYYYYYYYYYYYYYYYYYYYYGGGGGGGGGGGGGGGGGGGGGGG
BBWWRRWKKKWKKKWKKKWKKWWWWKKKWBBBBBBBWWYYYYYWYYYYYWKKKWKKKWKKKWGGGGGGGGGYYGGGGGGGGGGGGGGGGGGGGGGGGGGGGGGGGGGGG
BBWWRRWKKKWKKKWKKKWKKWWWWKKKWBBBRBBBWWYYYYYWYYYYYWKKKWKKKWKKKWGGGGGGGGGYYGGGGGGGGGGGGGGGGGGGGGGGGGGGGGGGGGGGG
BBWWRRWKKKWKKKWKKKWKKWWWWKKKWBBBBBBBWWYYYYYWYYYYYWKKKWKKKWKKKWGGGGGGGGGYYGGGGGGGGGGGGGGGGGGGGGGGGGGGGGGGGGGGG
WWWWWWWKKKWKKKWKKKWWWWKKWKKKWWWKKKWWWWYYYYYWYYYYYWKKKWKKKWKKWWWWWWWWWWWKKWWWWWWWWWWWWWWWWWWWWWWWWWWWWWWWWWWWW
KKKKKKKKKKWWWWWKKKKKKWWWWKKKKKKKKKKKKWYYYYYWYYYYYWKKKWWWWWKKKKKKKKKKKKKKKKKKKKKKKKKKKKKKKKKKKKKKKKKKKKKKKKKKK
KKKKKKKKKKWWWWWKKKKKKWWWWKKKKKKKKKKKKWYYYYYWYYYYYWKKKWWWWWKKKKKKKKKKKKKKKKKKKKKKKKKKKKKKKKKKKKKKKKKKKKKKKKKKK
WWWWWWWWWWWKKKWWWWWWWWKKWWWWWWWWWWWWWWYYYYYWYYYYYWWWWWKKWWWWWWWWWWWWWWWWWWWWWWWWWWWWWWWWWWWWWWWWWWWWWWWWWWWWW
KKKKKKKKKKKKKKKKKKKKKKKKKKKKKKKKKKKKKWYYYYYWYYYYYWKKKKKKKKKKKKKKKKKKKKKKKKKKKKKKKKKKKKKKKKKKKKKKKKKKKKKKKKKKK
WWKKWWKKWWKKWWKKWWKKWWKKWWKKWWKKWWKKWWYYYYYWYYYYYWWKKWWKKWWKKWWKKWWKKWWKKWWKKWWKKWWKKWWKKWWKKWWKKWWKKWWKKWWKK
KKKKKKKKKKKKKKKKKKKKKKKKKKKKKKKKKKKKKWYYYYYWYYYYYWKKKKKKKKKKKKKKKKKKKKKKKKKKKKKKKKKKKKKKKKKKKKKKKKKKKKKKKKKKK
WWWWWWWWWWWWWWWWWWWWWWWWWKKKWWWWWWWWWWYYYYYWYYYYYWWWWWWWWWWWWWWWWWWWWWWWWWWWKKWWWWWWWWWWWWWWWWWWWWWWWWWWWWWWW
KKKKKKKKKKKKKKKKKKKKKKKKWWWWWKKKKKKKKWYYYYYWYYYYYWKKKKKKKKKKKKKKKKKKKKKKKKKWWWWKKKKKKKKKKKKKKKKKKKKKKKKKKKKKK
KKKKKKKKKKKKKKKKKKKKKKKKWWWWWKKKKKKKKWYYYYYWYYYYYWKKKKKKKKKKKKKKKKKKKKKKKKKWWWWKKKKKKKKKKKKKKKKKKKKKKKKKKKKKK
WWWWWWWWWWWWWWWWWWWWWKKKWKKKWKKKKKKKKWYYYYYWYYYYYWKKKKKKKKKKKKKKKKKKKKKKKKKWKKWKKKRRRRRRRRRRRRMKKKMRRRRRRRRRR
BBBBBBWGGGGGGWYYYYYYWKKKWKKKWKKKKKKKKWYYYYYWYYYYYWKKKKKKKKKKKKKKKKKKKKKKKKKWKKWKKKRMMMMMMMMMMMMWWMMMMMMMMMMMM
BBBBBBWGGGGGGWYYYYYYWKKKWKKKWKKKKKKKKWYYYYYWYYYYYWKKKKKKKKKKKKKKKKKKKKKKKKKWKKWKKKRMKCCCCCCCCCCCCCCCCCCCCCCCK
BBBBBBWGGGGGGWYYYYYYWKKKWKKKWKKKKKKKKWYYYYYWYYYYYWKKKKKKKKKKKKKKKKKKKKKKKKKWKKWKKKRMKCGGGGGWCKKKKKKKCWGGGGGCK
WWKKWWWWWKKWWWWWKKWWWKKKWKKKWKKKKKKKKWYYYYYWYYYYYWKKKKKKKKKKKKKKKKKKKKKKKKKWKKWKKKRMKCCCCCCCCCCCCCCCCCCCCCCCK
KKKKKKKKKKKKKKKKKKKKKKKKWKKKWKKKKKKKKWYYYYYWYYYYYWKKKKKKKKKKKKKKKKKKKKKKKKKWKKWKKKRMKCGGGGGWCKKKKKKKCWGGGGGCK
KKKKKKKKKKKKKKKKKKKKKKKKWKKKWKKKKKKKKWYYYYYWYYYYYWKKKKKKKKKKKKKKKKKKKKKKKKKWKKWKKKRMKCCCCCCCCCCCCCCCCCCCCCCCK
WWWWWWWWWWWWWWWWWWWWWKKKWKKKWKKKKKKKKWYYYYYWYYYYYWKKKKKKKKKKKKKKKKKKKKKKKKKWKKWKKKRMKCGGGGGWCKKKKKKKCWGGGGGCK
YYYYYYWBBBBBBWRRRRRRWKKKWKKKWKKKKKKKKWYYYYYWYYYYYWKKKKKKKKKKKKKKKKKKKKKKKKKWKKWKKKRMKCCCCCCCCCCCCCCCCCCCCCCCK
