109 30
██████░░░│    │░░│   ‗‗‗│░░│█████████╣│───│║│───│╠░░│    │░░│▒▒▒▒▓▓▒▒▒▒▒▒▒▒▒▒▒▒▒▒▒▒▒▓▓▒▒▒▒▒▒▒▒▒▒▒▒▒▒▒▒▒▒▒▓▓▒▒
██████░░░│    │░░│   ‗‗‗│░░│█████████╣│───│║│───│╠░░│    │░░│▒▒▒▒▓▓▒▒▒▒▒▒▒▒▒▒▒▒▒▒▒▒▒▓▓▒▒▒▒▒▒▒▒▒▒▒▒▒▒▒▒▒▒▒▓▓▒▒
██████░░░│    │░░│   ‗‗‗│░░│█████████╣│───│║│───│╠░░│    │░░│▒▒▒▒▓▓▒▒▒▒▒▒▒▒▒▒▒▒▒▒▒▒▒▓▓▒▒▒▒▒▒▒▒▒▒▒▒▒▒▒▒▒▒▒▓▓▒▒
██████░░░│    │░░│   ‗‗‗│░░│█████████╣│───│║│───│╠░░│    │░░│▒▒▒▒▓▓▒▒▒▒▒▒▒▒▒▒▒▒▒▒▒▒▒▓▓▓▓▓▓▓▓▓▓▓▓▓▓▓▓▓▓▓▓▓▓▓▒▒
███████░░│    │░░│   ‗‗‗│░░│█████████╣│───│║│───│╠░░│    │░░│▒▒▒▒▓▓▒▒▒▒▒▒▒▒▒▒▒▒▒▒▒▒▒▓▓▓▓▓▓▓▓▓▓▓▓▓▓▓▓▓▓▓▓▓▓▓▒▒
███████░░│    │░░│   ‗‗‗│░░│█████████╣│───│║│───│╠░░│    │░░│▒▒▒▒▓▓▒▒▒▒▒▒▒▒▒▒▒▒▒▒▒▒▒▓▓▒▒▒▒▒▒▒▒▒▒▒▒▒▒▒▒▒▒▒▒▒▒▒
██████░░░│    │░░│   ‗‗‗│░░│█████████╣│───│║│───│╠░░│    │░░│▒▒▒▒▓▓▓▓▓▓▓▓▓▓▓▓▓▓▓▓▓▓▓▓▓▒▒▒▒▒▒▒▒▒▒▒▒▒▒▒▒▒▒▒▒▒▒▒
██████░░░│    │░░│   ‗‗‗│░░│█████████╣│───│║│───│╠░░│    │░░│▒▒▒▒▓▓▓▓▓▓▓▓▓▓▓▓▓▓▓▓▓▓▓▓▓▒▒▒▒▒▒▒▒▒▒▒▒▒▒▒▒▒▒▒▒▒▒▒
██████░░░│    │░░│   ‗‗‗│░░│█████████╣│───│║│───│╠░░│    │░░│▒▒▒▒▒▒▒▒▒▒▓▓▒▒▒▒▒▒▒▒▒▒▒▒▒▒▒▒▒▒▒▒▒▒▒▒▒▒▒▒▒▒▒▒▒▒▒▒
██████░░░│    │░░│   ‗‗‗│░░│█████████╣│───│║│───│╠░░│    │░░│▒▒▒▒▒▒▒▒▒▒▓▓▒▒▒▒▒▒▒▒▒▒▒▒▒▒▒▒▒▒▒▒▒▒▒▒▒▒▒▒▒▒▒▒▒▒▒▒
██████░░░│    │░░│      │░░│█████████╣│───│║│───│╠░░│    │░░│▒▒▒▒▒▒▒▒▒▒▓▓▒▒▒▒▒▒▒▒▒▒▒▒▒▒▒▒▒▒▒▒▒▒▒▒▒▒▒▒▒▒▒▒▒▒▒▒
██████░░░│    │░░└──┐   │░░░░░███░░░░╣│───│║│───│╠░░│    │░░└─────────┘▓▓└───────────────────────────────────
░░░░░░░░░││││││░░░░░│││││░░░░░░░░░░░░╣│───│║│───│╠░░││││││░░░░░░░░░░░░░░░░░░░░░░░░░░░░░░░░░░░░░░░░░░░░░░░░░░░
░░░░░░░░░││││││░░░░░│││││░░░░░░░░░░░░╣│───│║│───│╠░░││││││░░░░░░░░░░░░░░░░░░░░░░░░░░░░░░░░░░░░░░░░░░░░░░░░░░░
─────────┘    └─────┘   └────────────╣│───│║│───│╠──┘    └───────────────────────────────────────────────────
                                     ║│───│║│───│║                                                           
══  ══  ══  ══  ══  ══  ══  ══  ══  ═║│───│║│───│║═  ══  ══  ══  ══  ══  ══  ══  ══  ══  ══  ══  ══  ══  ══  
                                     ║│───│║│───│║                                                           
───────────────────────┐    ┌────────╣│───│║│───│╠────────────────────────┐    ┌─────────────────────────────
░░░░░░░░░░░░░░░░░░░░░░░││││││░░░░░░░░╣│───│║│───│╠░░░░░░░░░░░░░░░░░░░░░░░░││││││░░░░░░░░░░░░░░░░░░░░░░░░░░░░░
░░░░░░░░░░░░░░░░░░░░░░░││││││░░░░░░░░╣│───│║│───│╠░░░░░░░░░░░░░░░░░░░░░░░░││││││░░░░░░░░░░░░░░░░░░░░░░░░░░░░░
══════╦══════╦══════╗░░│    │░░      ╣│───│║│───│╠                      ░░│    │░░░░░░░░░░░░░░████░░░░░░░░░░░
██████║██████║██████║░░│    │░░      ╣│───│║│───│╠                      ░░│    │░░███████████████████████████
██████║██████║██████║░░│    │░░      ╣│───│║│───│╠                      ░░│    │░░██ │                    │ █
██████║██████║██████║░░│    │░░      ╣│───│║│───│╠                      ░░│    │░░██ ├────────────────────┤ █
══════╩══════╩══════╝░░│    │░░      ╣│───│║│───│╠                      ░░│    │░░██ │▒▒▒▒▒■│      │■▒▒▒▒▒│ █
░░░░░░░░░░░░░░░░░░░░░░░│    │░░      ╣│───│║│───│╠                      ░░│    │░░██ ├──────┼──────┼──────┤ █
░░░░░░░░░░░░░░░░░░░░░░░│    │░░      ╣│───│║│───│╠                      ░░│    │░░██ │▒▒▒▒▒■│      │■▒▒▒▒▒│ █
══════╦══════╦══════╗░░│    │░░      ╣│───│║│───│╠                      ░░│    │░░██ ├──────┼──────┼──────┤ █
██████║██████║██████║░░│    │░░      ╣│───│║│───│╠                      ░░│    │░░██ │▒▒▒▒▒■│      │■▒▒▒▒▒│ █