109 30
██████│   │   │   │   ‗‗│   │███████║╣│───│║│───│╠   │   │   │▒▒▒   ▒▒▒▒▒▒▒▒▒▒▒▒▒▒▒▒   ▒▒▒▒▒▒▒▒▒▒▒▒▒▒▒▒▒▒   ▒
██████║   │   │   │   ‗‗│   │███████║╣│───│║│───│╠   │   │   │▒▒▒   ▒▒▒▒▒▒▒▒▒▒▒▒▒▒▒▒   ▒▒▒▒▒▒▒▒▒▒▒▒▒▒▒▒▒▒   ▒
██████│   │   │   │   ‗‗│   ║███████║╣│───│║│───│╠   │   │   │▒▒▒   ▒▒▒▒▒▒▒▒▒▒▒▒▒▒▒▒   ▒▒▒▒▒▒▒▒▒▒▒▒▒▒▒▒▒▒   ▒
██████╚   │   │   │   ‗‗│   │███████║╣│───│║│───│╠   │   │   │▒▒▒   ▒▒▒▒▒▒▒▒▒▒▒▒▒▒▒▒                        ▒
██████▓   │   │   │   ‗‗│   │███████║╣│───│║│───│╠   │   │   │▒▒▒   ▒▒▒▒▒▒▒▒▒▒▒▒▒▒▒▒                        ▒
██████▓   │   │   │   ‗‗│   ║███████║╣│───│║│───│╠   │   │   │▒▒▒   ▒▒▒▒▒▒▒▒▒▒▒▒▒▒▒▒   ▒▒▒▒▒▒▒▒▒▒▒▒▒▒▒▒▒▒▒▒▒▒
██████╔   │   │   │   ‗‗│   │███████║╣│───│║│───│╠   │   │   │▒▒▒                      ▒▒▒▒▒▒▒▒▒▒▒▒▒▒▒▒▒▒▒▒▒▒
██████│   │   │   │   ‗‗│   │███████║╣│───│║│───│╠   │   │   │▒▒▒                      ▒▒▒▒▒▒▒▒▒▒▒▒▒▒▒▒▒▒▒▒▒▒
██████║   │   │   │   ‗‗│   ║███████║╣│───│║│───│╠   │   │   │▒▒▒▒▒▒▒▒▒   ▒▒▒▒▒▒▒▒▒▒▒▒▒▒▒▒▒▒▒▒▒▒▒▒▒▒▒▒▒▒▒▒▒▒▒
██████│   │   │   │   ‗‗│   │███████║╣│───│║│───│╠   │   │   │▒▒▒▒▒▒▒▒▒   ▒▒▒▒▒▒▒▒▒▒▒▒▒▒▒▒▒▒▒▒▒▒▒▒▒▒▒▒▒▒▒▒▒▒▒
██████║   │   │   │     │   │███████║╣│───│║│───│╠   │   │   │▒▒▒▒▒▒▒▒▒   ▒▒▒▒▒▒▒▒▒▒▒▒▒▒▒▒▒▒▒▒▒▒▒▒▒▒▒▒▒▒▒▒▒▒▒
──═──═╝   │   │   └──┐  │   ╚─╗▓▓▓╔─╝╣│───│║│───│╠   │   │   └────────┘   └──────────────────────────────────
          │││││      ││││            ║│───│║│───│║   │││││                                                   
          │││││      ││││            ║│───│║│───│║   │││││                                                   
──────────┘   └──────┘  └────────────║│───│║│───│║───┘   └───────────────────────────────────────────────────
                                     ║│───│║│───│║                                                           
══  ══  ══  ══  ══  ══  ══  ══  ══  ═║│───│║│───│║═  ══  ══  ══  ══  ══  ══  ══  ══  ══  ══  ══  ══  ══  ══  
                                     ║│───│║│───│║                                                           
────────────────────────┐   ┌────────║│───│║│───│║─────────────────────────┐  ┌──────────────────────────────
                        │││││        ║│───│║│───│║                         ││││                              
                        │││││        ║│───│║│───│║                         ││││                              
═─══─═╦═─══─═╦═─══─═╗   │   │        ╣│───│║│───│╠                         │  │   ╔══════════╝█   █╚═════════
██████║██████║██████║   │   │        ╣│───│║│───│╠                         │  │   ║████████████   ███████████
██████║██████║██████│   │   │        ╣│───│║│───│╠                         │  │   ║█ ┌──────┬─┘   └─┬──────┐ 
██████║██████║██████║   │   │        ╣│───│║│───│╠                         │  │   ║█ │▒▒▒▒▒█│       │█▒▒▒▒▒│ 
═╗▓▓╔═╩═╗▓▓╔═╩═╗▓▓╔═╝   │   │        ╣│───│║│───│╠                         │  │   ║█ ├──────┼───────┼──────┤ 
                        │   │        ╣│───│║│───│╠                         │  │   ║█ │▒▒▒▒▒█│       │█▒▒▒▒▒│ 
                        │   │        ╣│───│║│───│╠                         │  │   ║█ ├──────┼───────┼──────┤ 
═─══─═╦═─══─═╦═─══─═╗   │   │        ╣│───│║│───│╠                         │  │   ║█ │▒▒▒▒▒█│       │█▒▒▒▒▒│ 
██████║██████║██████║   │   │        ╣│───│║│───│╠                         │  │   ║█ ├──────┼───────┼──────┤ 
