██████│  │    │  │   ‗‗‗│  │████████ 8888888888888  │    │  │▒▒▒▒▓▓▒▒▒▒▒▒▒▒▒▒▒▒▒▒▒▒▒▓▓▒▒▒▒▒▒▒▒▒▒▒▒▒▒▒▒▒▒▒▓▓▒▒
██████║  │    │  │   ‗‗‗│  │████████ 8888888888888  │    │  │▒▒▒▒▓▓▒▒▒▒▒▒▒▒▒▒▒▒▒▒▒▒▒▓▓▒▒▒▒▒▒▒▒▒▒▒▒▒▒▒▒▒▒▒▓▓▒▒
██████│  │    │  │   ‗‗‗│  ║████████ 8888888888888  │    │  │▒▒▒▒▓▓▒▒▒▒▒▒▒▒▒▒▒▒▒▒▒▒▒▓▓▒▒▒▒▒▒▒▒▒▒▒▒▒▒▒▒▒▒▒▓▓▒▒
██████╚  │    │  │   ‗‗‗│  │████████ 8888888888888  │    │  │▒▒▒▒▓▓▒▒▒▒▒▒▒▒▒▒▒▒▒▒▒▒▒▓▓▓▓▓▓▓▓▓▓▓▓▓▓▓▓▓▓▓▓▓▓▓▒▒
██████▓  │    │  │   ‗‗‗│  │████████ 8888888888888  │    │  │▒▒▒▒▓▓▒▒▒▒▒▒▒▒▒▒▒▒▒▒▒▒▒▓▓▓▓▓▓▓▓▓▓▓▓▓▓▓▓▓▓▓▓▓▓▓▒▒
██████▓  │    │  │   ‗‗‗│  ║████████ 8888888888888  │    │  │▒▒▒▒▓▓▒▒▒▒▒▒▒▒▒▒▒▒▒▒▒▒▒▓▓▒▒▒▒▒▒▒▒▒▒▒▒▒▒▒▒▒▒▒▒▒▒▒
██████╔  │    │  │   ‗‗‗│  │████████ 8888888888888  │    │  │▒▒▒▒▓▓▓▓▓▓▓▓▓▓▓▓▓▓▓▓▓▓▓▓▓▒▒▒▒▒▒▒▒▒▒▒▒▒▒▒▒▒▒▒▒▒▒▒
██████│  │    │  │   ‗‗‗│  │████████ 8888888888888  │    │  │▒▒▒▒▓▓▓▓▓▓▓▓▓▓▓▓▓▓▓▓▓▓▓▓▓▒▒▒▒▒▒▒▒▒▒▒▒▒▒▒▒▒▒▒▒▒▒▒
██████║  │    │  │   ‗‗‗│  ║████████ 8888888888888  │    │  │▒▒▒▒▒▒▒▒▒▒▓▓▒▒▒▒▒▒▒▒▒▒▒▒▒▒▒▒▒▒▒▒▒▒▒▒▒▒▒▒▒▒▒▒▒▒▒▒
██████│  │    │  │   ‗‗‗│  │████████ 8888888888888  │    │  │▒▒▒▒▒▒▒▒▒▒▓▓▒▒▒▒▒▒▒▒▒▒▒▒▒▒▒▒▒▒▒▒▒▒▒▒▒▒▒▒▒▒▒▒▒▒▒▒
██████║  │    │  │      │  │████████ 8888888888888  │    │  │▒▒▒▒▒▒▒▒▒▒▓▓▒▒▒▒▒▒▒▒▒▒▒▒▒▒▒▒▒▒▒▒▒▒▒▒▒▒▒▒▒▒▒▒▒▒▒▒
──═──═╝  │    │  └───┐  │  ╚─╗▓▓▓▓╔─ 8888888888888  │    │  └─────────┘  └───────────────────────────────────
         ││││││      ││││            8888888888888  ││││││
         ││││││      ││││            8888888888888  ││││││
─────────┘    └──────┘  └────────────8888888888888──┘    └───────────────────────────────────────────────────
                                     8888888888888
══  ══  ══  ══  ══  ══  ══  ══  ══  ═8888888888888═  ══  ══  ══  ══  ══  ══  ══  ══  ══  ══  ══  ══  ══  ══
                                     8888888888888
───────────────────────┐    ┌────────8888888888888────────────────────────┐    ┌─────────────────────────────
                       ││││││        8888888888888                        ││││││
                       ││││││        8888888888888                        ││││││
═─══─═╦═─══─═╦═─══─═╗  │    │        8888888888888                        │    │  ╔══════════╝█88█╚══════════
██████║██████║██████║  │    │        8888888888888                        │    │  ║████████████  ████████████
██████║██████║██████│  │    │        8888888888888                        │    │  ║█ ┌──────┬─┘  └─┬──────┐ █
██████║██████║██████║  │    │        8888888888888                        │    │  ║█ │▒▒▒▒▒█│      │█▒▒▒▒▒│ █
═╗▓▓╔═╩═╗▓▓╔═╩═╗▓▓╔═╝  │    │        8888888888888                        │    │  ║█ ├──────┼──────┼──────┤ █
                       │    │        8888888888888                        │    │  ║█ │▒▒▒▒▒█│      │█▒▒▒▒▒│ █
                       │    │        8888888888888                        │    │  ║█ ├──────┼──────┼──────┤ █
═─══─═╦═─══─═╦═─══─═╗  │    │        8888888888888                        │    │  ║█ │▒▒▒▒▒█│      │█▒▒▒▒▒│ █
██████║██████║██████║  │    │        8888888888888                        │    │  ║█ ├──────┼──────┼──────┤ █
