109 30
██████│   │   │   │   ‗‗│   │███████║ │───│ │───│    │   │   │▒▒▒   ▒▒▒▒▒▒▒▒▒▒▒▒▒▒▒▒   ▒▒▒▒▒▒▒▒▒▒▒▒▒▒▒▒▒▒   ▒
██████║   │   │   │   ‗‗│   │███████║ │───│ │───│    │   │   │▒▒▒   ▒▒▒▒▒▒▒▒▒▒▒▒▒▒▒▒   ▒▒▒▒▒▒▒▒▒▒▒▒▒▒▒▒▒▒   ▒
██████│   │   │   │   ‗‗│   ║███████║ │───│ │───│    │   │   │▒▒▒   ▒▒▒▒▒▒▒▒▒▒▒▒▒▒▒▒   ▒▒▒▒▒▒▒▒▒▒▒▒▒▒▒▒▒▒   ▒
██████╚   │   │   │   ‗‗│   │███████║ │───│ │───│    │   │   │▒▒▒   ▒▒▒▒▒▒▒▒▒▒▒▒▒▒▒▒                        ▒
██████▓   │   │   │   ‗‗│   │███████║ │───│ │───│    │   │   │▒▒▒   ▒▒▒▒▒▒▒▒▒▒▒▒▒▒▒▒                        ▒
██████▓   │   │   │   ‗‗│   ║███████║ │───│ │───│    │   │   │▒▒▒   ▒▒▒▒▒▒▒▒▒▒▒▒▒▒▒▒   ▒▒▒▒▒▒▒▒▒▒▒▒▒▒▒▒▒▒▒▒▒▒
██████╔   │   │   │   ‗‗│   │███████║ │───│ │───│    │   │   │▒▒▒                      ▒▒▒▒▒▒▒▒▒▒▒▒▒▒▒▒▒▒▒▒▒▒
██████│   │   │   │   ‗‗│   │███████║ │───│ │───│    │   │   │▒▒▒                      ▒▒▒▒▒▒▒▒▒▒▒▒▒▒▒▒▒▒▒▒▒▒
██████║   │   │   │   ‗‗│   ║███████║ │───│ │───│    │   │   │▒▒▒▒▒▒▒▒▒   ▒▒▒▒▒▒▒▒▒▒▒▒▒▒▒▒▒▒▒▒▒▒▒▒▒▒▒▒▒▒▒▒▒▒▒
██████│   │   │   │   ‗‗│   │███████║ │───│ │───│    │   │   │▒▒▒▒▒▒▒▒▒   ▒▒▒▒▒▒▒▒▒▒▒▒▒▒▒▒▒▒▒▒▒▒▒▒▒▒▒▒▒▒▒▒▒▒▒
██████║   │   │   │     │   │███████║ │───│ │───│    │   │   │▒▒▒▒▒▒▒▒▒   ▒▒▒▒▒▒▒▒▒▒▒▒▒▒▒▒▒▒▒▒▒▒▒▒▒▒▒▒▒▒▒▒▒▒▒
──═──═╝   │   │   └──┐  │   ╚─╗▓▓▓╔─╝╗│───│ │───│╔   │   │   └────────┘   └──────────────────────────────────
          │││││      ││││            ║│───│ │───│║   │││││                                                   
          │││││      ││││            ║│───│ │───│║   │││││                                                   
──────────┘   └──────┘  └────────────║│───│ │───│║───┘   └───────────────────────────────────────────────────
                                     ║│───│ │───│║                                                           
══  ══  ══  ══  ══  ══  ══  ══  ══  ═║│───│ │───│║═  ══  ══  ══  ══  ══  ══  ══  ══  ══  ══  ══  ══  ══  ══  
                                     ║│───│ │───│║                                                           
────────────────────────┐   ┌────────║│───│ │───│║─────────────────────────┐  ┌──────────────────────────────
                        │││││        ║│───│ │───│║                         ││││                              
                        │││││        ║│───│ │───│║                         ││││                              
═─══─═╦═─══─═╦═─══─═╗   │   │        ║│───│ │───│║                         │  │   ╔══════════╝█   █╚═════════
██████║██████║██████║   │   │        ║│───│ │───│║                         │  │   ║████████████   ███████████
██████║██████║██████│   │   │        ║│───│ │───│║                         │  │   ║█ ┌──────┬─┘   └─┬──────┐ 
██████║██████║██████║   │   │        ║│───│ │───│║                         │  │   ║█ │▒▒▒▒▒█│       │█▒▒▒▒▒│ 
═╗▓▓╔═╩═╗▓▓╔═╩═╗▓▓╔═╝   │   │        ║│───│ │───│║                         │  │   ║█ ├──────┼───────┼──────┤ 
                        │   │        ║│───│ │───│║                         │  │   ║█ │▒▒▒▒▒█│       │█▒▒▒▒▒│ 
                        │   │        ║│───│ │───│║                         │  │   ║█ ├──────┼───────┼──────┤ 
═─══─═╦═─══─═╦═─══─═╗   │   │        ║│───│ │───│║                         │  │   ║█ │▒▒▒▒▒█│       │█▒▒▒▒▒│ 
██████║██████║██████║   │   │        ║│───│ │───│║                         │  │   ║█ ├──────┼───────┼──────┤ 
