110 34
██████░░░│     │░░│   ‗‗‗│░░│████████╣│───│║│───│╠░░│     │░░│▒▒▒▒▓▓▒▒▒▒▒▒▒▒▒▒▒▒▒▒▒▒▒▓▓▒▒▒▒▒▒▒▒▒▒▒▒▒▒▒▒▒▒▒▓▓▒▒
██████░░░│     │░░│   ‗‗‗│░░│████████╣│───│║│───│╠░░│     │░░│▒▒▒▒▓▓▒▒▒▒▒▒▒▒▒▒▒▒▒▒▒▒▒▓▓▒▒▒▒▒▒▒▒▒▒▒▒▒▒▒▒▒▒▒▓▓▒▒
██████░░░│     │░░│   ‗‗‗│░░│████████╣│───│║│───│╠░░│     │░░│▒▒▒▒▓▓▒▒▒▒▒▒▒▒▒▒▒▒▒▒▒▒▒▓▓▒▒▒▒▒▒▒▒▒▒▒▒▒▒▒▒▒▒▒▓▓▒▒
██████░░░│     │░░│   ‗‗‗│░░│████████╣│───│║│───│╠░░│     │░░│▒▒▒▒▓▓▒▒▒▒▒▒▒▒▒▒▒▒▒▒▒▒▒▓▓▓▓▓▓▓▓▓▓▓▓▓▓▓▓▓▓▓▓▓▓▓▒▒
███████░░│     │░░│   ‗‗‗│░░│████████╣│───│║│───│╠░░│     │░░│▒▒▒▒▓▓▒▒▒▒▒▒▒▒▒▒▒▒▒▒▒▒▒▓▓▓▓▓▓▓▓▓▓▓▓▓▓▓▓▓▓▓▓▓▓▓▒▒
███████░░│     │░░│   ‗‗‗│░░│████████╣│───│║│───│╠░░│     │░░│▒▒▒▒▓▓▒▒▒▒▒▒▒▒▒▒▒▒▒▒▒▒▒▓▓▒▒▒▒▒▒▒▒▒▒▒▒▒▒▒▒▒▒▒▒▒▒▒
██████░░░│     │░░│   ‗‗‗│░░│████████╣│───│║│───│╠░░│     │░░│▒▒▒▒▓▓▓▓▓▓▓▓▓▓▓▓▓▓▓▓▓▓▓▓▓▒▒▒▒▒▒▒▒▒▒▒▒▒▒▒▒▒▒▒▒▒▒▒
██████░░░│     │░░│   ‗‗‗│░░│████████╣│───│║│───│╠░░│     │░░│▒▒▒▒▓▓▓▓▓▓▓▓▓▓▓▓▓▓▓▓▓▓▓▓▓▒▒▒▒▒▒▒▒▒▒▒▒▒▒▒▒▒▒▒▒▒▒▒
██████░░░│     │░░│   ‗‗‗│░░│████████╣│───│║│───│╠░░│     │░░│▒▒▒▒▒▒▒▒▒▒▓▓▒▒▒▒▒▒▒▒▒▒▒▒▒▒▒▒▒▒▒▒▒▒▒▒▒▒▒▒▒▒▒▒▒▒▒▒
██████░░░│     │░░│   ‗‗‗│░░│████████╣│───│║│───│╠░░│     │░░│▒▒▒▒▒▒▒▒▒▒▓▓▒▒▒▒▒▒▒▒▒▒▒▒▒▒▒▒▒▒▒▒▒▒▒▒▒▒▒▒▒▒▒▒▒▒▒▒
██████░░░│     │░░│      │░░│████████╣│───│║│───│╠░░│     │░░│▒▒▒▒▒▒▒▒▒▒▓▓▒▒▒▒▒▒▒▒▒▒▒▒▒▒▒▒▒▒▒▒▒▒▒▒▒▒▒▒▒▒▒▒▒▒▒▒
██████░░░│     │░░└──┐   │░░░░░███░░░╣│───│║│───│╠░░│     │░░└─────────┘▓▓└───────────────────────────────────
░░░░░░░░░│││││││░░░░░│││││░░░░░░░░░░░╣│───│║│───│╠░░│││││││░░░░░░░░░░░░░░░░░░░░░░░░░░░░░░░░░░░░░░░░░░░░░░░░░░░
░░░░░░░░░│││││││░░░░░│││││░░░░░░░░░░░╣│───│║│───│╠░░│││││││░░░░░░░░░░░░░░░░░░░░░░░░░░░░░░░░░░░░░░░░░░░░░░░░░░░
─────────┘     └─────┘   └───────────╣│───│║│───│╠──┘     └───────────────────────────────────────────────────
                                     ║│───│║│───│║                                                            
                                     ║│───│║│───│║                                                            
                                     ║│───│║│───│║                                                            
══  ══  ══  ══  ══  ══  ══  ══  ══  ═║│───│║│───│║═  ══  ══  ══  ══  ══  ══  ══  ══  ══  ══  ══  ══  ══  ══  ═
                                     ║│───│║│───│║                                                            
                                     ║│───│║│───│║                                                            
                                     ║│───│║│───│║                                                            
───────────────────────┐     ┌───────╣│───│║│───│╠────────────────────────┐     ┌─────────────────────────────
░░░░░░░░░░░░░░░░░░░░░░░│││││││░░░░░░░╣│───│║│───│╠░░░░░░░░░░░░░░░░░░░░░░░░│││││││░░░░░░░░░░░░░░░░░░░░░░░░░░░░░
░░░░░░░░░░░░░░░░░░░░░░░│││││││░░░░░░░╣│───│║│───│╠░░░░░░░░░░░░░░░░░░░░░░░░│││││││░░░░░░░░░░░░░░░░░░░░░░░░░░░░░
══════╦══════╦══════╗░░│     │░░     ╣│───│║│───│╠                      ░░│     │░░░░░░░░░░░░░░████░░░░░░░░░░░
██████║██████║██████║░░│     │░░     ╣│───│║│───│╠                      ░░│     │░░███████████████████████████
██████║██████║██████║░░│     │░░     ╣│───│║│───│╠                      ░░│     │░░██ │                    │ █
██████║██████║██████║░░│     │░░     ╣│───│║│───│╠                      ░░│     │░░██ ├────────────────────┤ █
══════╩══════╩══════╝░░│     │░░     ╣│───│║│───│╠                      ░░│     │░░██ │▒▒▒▒▒■│      │■▒▒▒▒▒│ █
░░░░░░░░░░░░░░░░░░░░░░░│     │░░     ╣│───│║│───│╠                      ░░│     │░░██ ├──────┼──────┼──────┤ █
░░░░░░░░░░░░░░░░░░░░░░░│     │░░     ╣│───│║│───│╠                      ░░│     │░░██ │▒▒▒▒▒■│      │■▒▒▒▒▒│ █
══════╦══════╦══════╗░░│     │░░     ╣│───│║│───│╠                      ░░│     │░░██ ├──────┼──────┼──────┤ █
██████║██████║██████║░░│     │░░     ╣│───│║│───│╠                      ░░│     │░░██ │▒▒▒▒▒■│      │■▒▒▒▒▒│ █